; Goldman p. 379
saKi,m_irr	saKA:saKAyO:saKAyaH:saKAyam:saKAyO:saKIn:saKyA:saKiByAm:saKiBiH:saKye:saKiByAm:saKiByaH:saKyuH:saKiByAm:saKiByaH:saKyuH:saKyoH:saKInAm:saKyO:saKyoH:saKizu:saKe:saKAyO:saKAyaH
; compounds of saKi, in masculine, from MW. 
; currently assume f. and n. genders declined like nominals ending in 'i'
a-saKi,m_irr	asaKA:asaKAyO:asaKAyaH:asaKAyam:asaKAyO:asaKIn:asaKyA:asaKiByAm:asaKiBiH:asaKye:asaKiByAm:asaKiByaH:asaKyuH:asaKiByAm:asaKiByaH:asaKyuH:asaKyoH:asaKInAm:asaKyO:asaKyoH:asaKizu:asaKe:asaKAyO:asaKAyaH
asmat-saKi,m_irr	asmatsaKA:asmatsaKAyO:asmatsaKAyaH:asmatsaKAyam:asmatsaKAyO:asmatsaKIn:asmatsaKyA:asmatsaKiByAm:asmatsaKiBiH:asmatsaKye:asmatsaKiByAm:asmatsaKiByaH:asmatsaKyuH:asmatsaKiByAm:asmatsaKiByaH:asmatsaKyuH:asmatsaKyoH:asmatsaKInAm:asmatsaKyO:asmatsaKyoH:asmatsaKizu:asmatsaKe:asmatsaKAyO:asmatsaKAyaH
arjuna-saKi,m_irr	arjunasaKA:arjunasaKAyO:arjunasaKAyaH:arjunasaKAyam:arjunasaKAyO:arjunasaKIn:arjunasaKyA:arjunasaKiByAm:arjunasaKiBiH:arjunasaKye:arjunasaKiByAm:arjunasaKiByaH:arjunasaKyuH:arjunasaKiByAm:arjunasaKiByaH:arjunasaKyuH:arjunasaKyoH:arjunasaKInAm:arjunasaKyO:arjunasaKyoH:arjunasaKizu:arjunasaKe:arjunasaKAyO:arjunasaKAyaH
indra-saKi,m_irr	indrasaKA:indrasaKAyO:indrasaKAyaH:indrasaKAyam:indrasaKAyO:indrasaKIn:indrasaKyA:indrasaKiByAm:indrasaKiBiH:indrasaKye:indrasaKiByAm:indrasaKiByaH:indrasaKyuH:indrasaKiByAm:indrasaKiByaH:indrasaKyuH:indrasaKyoH:indrasaKInAm:indrasaKyO:indrasaKyoH:indrasaKizu:indrasaKe:indrasaKAyO:indrasaKAyaH
ISa-saKi,m_irr	ISasaKA:ISasaKAyO:ISasaKAyaH:ISasaKAyam:ISasaKAyO:ISasaKIn:ISasaKyA:ISasaKiByAm:ISasaKiBiH:ISasaKye:ISasaKiByAm:ISasaKiByaH:ISasaKyuH:ISasaKiByAm:ISasaKiByaH:ISasaKyuH:ISasaKyoH:ISasaKInAm:ISasaKyO:ISasaKyoH:ISasaKizu:ISasaKe:ISasaKAyO:ISasaKAyaH
kaRva-saKi,m_irr	kaRvasaKA:kaRvasaKAyO:kaRvasaKAyaH:kaRvasaKAyam:kaRvasaKAyO:kaRvasaKIn:kaRvasaKyA:kaRvasaKiByAm:kaRvasaKiBiH:kaRvasaKye:kaRvasaKiByAm:kaRvasaKiByaH:kaRvasaKyuH:kaRvasaKiByAm:kaRvasaKiByaH:kaRvasaKyuH:kaRvasaKyoH:kaRvasaKInAm:kaRvasaKyO:kaRvasaKyoH:kaRvasaKizu:kaRvasaKe:kaRvasaKAyO:kaRvasaKAyaH
kiM-saKi,m_irr	kiMsaKA:kiMsaKAyO:kiMsaKAyaH:kiMsaKAyam:kiMsaKAyO:kiMsaKIn:kiMsaKyA:kiMsaKiByAm:kiMsaKiBiH:kiMsaKye:kiMsaKiByAm:kiMsaKiByaH:kiMsaKyuH:kiMsaKiByAm:kiMsaKiByaH:kiMsaKyuH:kiMsaKyoH:kiMsaKInAm:kiMsaKyO:kiMsaKyoH:kiMsaKizu:kiMsaKe:kiMsaKAyO:kiMsaKAyaH
go-saKi,m_irr	gosaKA:gosaKAyO:gosaKAyaH:gosaKAyam:gosaKAyO:gosaKIn:gosaKyA:gosaKiByAm:gosaKiBiH:gosaKye:gosaKiByAm:gosaKiByaH:gosaKyuH:gosaKiByAm:gosaKiByaH:gosaKyuH:gosaKyoH:gosaKInAm:gosaKyO:gosaKyoH:gosaKizu:gosaKe:gosaKAyO:gosaKAyaH
deva-saKi,m_irr	devasaKA:devasaKAyO:devasaKAyaH:devasaKAyam:devasaKAyO:devasaKIn:devasaKyA:devasaKiByAm:devasaKiBiH:devasaKye:devasaKiByAm:devasaKiByaH:devasaKyuH:devasaKiByAm:devasaKiByaH:devasaKyuH:devasaKyoH:devasaKInAm:devasaKyO:devasaKyoH:devasaKizu:devasaKe:devasaKAyO:devasaKAyaH
nf-vat-saKi,m_irr	nfvatsaKA:nfvatsaKAyO:nfvatsaKAyaH:nfvatsaKAyam:nfvatsaKAyO:nfvatsaKIn:nfvatsaKyA:nfvatsaKiByAm:nfvatsaKiBiH:nfvatsaKye:nfvatsaKiByAm:nfvatsaKiByaH:nfvatsaKyuH:nfvatsaKiByAm:nfvatsaKiByaH:nfvatsaKyuH:nfvatsaKyoH:nfvatsaKInAm:nfvatsaKyO:nfvatsaKyoH:nfvatsaKizu:nfvatsaKe:nfvatsaKAyO:nfvatsaKAyaH
bAla-saKi,m_irr	bAlasaKA:bAlasaKAyO:bAlasaKAyaH:bAlasaKAyam:bAlasaKAyO:bAlasaKIn:bAlasaKyA:bAlasaKiByAm:bAlasaKiBiH:bAlasaKye:bAlasaKiByAm:bAlasaKiByaH:bAlasaKyuH:bAlasaKiByAm:bAlasaKiByaH:bAlasaKyuH:bAlasaKyoH:bAlasaKInAm:bAlasaKyO:bAlasaKyoH:bAlasaKizu:bAlasaKe:bAlasaKAyO:bAlasaKAyaH
mat-saKi,m_irr	matsaKA:matsaKAyO:matsaKAyaH:matsaKAyam:matsaKAyO:matsaKIn:matsaKyA:matsaKiByAm:matsaKiBiH:matsaKye:matsaKiByAm:matsaKiByaH:matsaKyuH:matsaKiByAm:matsaKiByaH:matsaKyuH:matsaKyoH:matsaKInAm:matsaKyO:matsaKyoH:matsaKizu:matsaKe:matsaKAyO:matsaKAyaH
marut-saKi,m_irr	marutsaKA:marutsaKAyO:marutsaKAyaH:marutsaKAyam:marutsaKAyO:marutsaKIn:marutsaKyA:marutsaKiByAm:marutsaKiBiH:marutsaKye:marutsaKiByAm:marutsaKiByaH:marutsaKyuH:marutsaKiByAm:marutsaKiByaH:marutsaKyuH:marutsaKyoH:marutsaKInAm:marutsaKyO:marutsaKyoH:marutsaKizu:marutsaKe:marutsaKAyO:marutsaKAyaH
vAyu-saKi,m_irr	vAyusaKA:vAyusaKAyO:vAyusaKAyaH:vAyusaKAyam:vAyusaKAyO:vAyusaKIn:vAyusaKyA:vAyusaKiByAm:vAyusaKiBiH:vAyusaKye:vAyusaKiByAm:vAyusaKiByaH:vAyusaKyuH:vAyusaKiByAm:vAyusaKiByaH:vAyusaKyuH:vAyusaKyoH:vAyusaKInAm:vAyusaKyO:vAyusaKyoH:vAyusaKizu:vAyusaKe:vAyusaKAyO:vAyusaKAyaH
SrAvayat-saKi,m_irr	SrAvayatsaKA:SrAvayatsaKAyO:SrAvayatsaKAyaH:SrAvayatsaKAyam:SrAvayatsaKAyO:SrAvayatsaKIn:SrAvayatsaKyA:SrAvayatsaKiByAm:SrAvayatsaKiBiH:SrAvayatsaKye:SrAvayatsaKiByAm:SrAvayatsaKiByaH:SrAvayatsaKyuH:SrAvayatsaKiByAm:SrAvayatsaKiByaH:SrAvayatsaKyuH:SrAvayatsaKyoH:SrAvayatsaKInAm:SrAvayatsaKyO:SrAvayatsaKyoH:SrAvayatsaKizu:SrAvayatsaKe:SrAvayatsaKAyO:SrAvayatsaKAyaH
su-saKi,m_irr	susaKA:susaKAyO:susaKAyaH:susaKAyam:susaKAyO:susaKIn:susaKyA:susaKiByAm:susaKiBiH:susaKye:susaKiByAm:susaKiByaH:susaKyuH:susaKiByAm:susaKiByaH:susaKyuH:susaKyoH:susaKInAm:susaKyO:susaKyoH:susaKizu:susaKe:susaKAyO:susaKAyaH
soma-saKi,m_irr	somasaKA:somasaKAyO:somasaKAyaH:somasaKAyam:somasaKAyO:somasaKIn:somasaKyA:somasaKiByAm:somasaKiBiH:somasaKye:somasaKiByAm:somasaKiByaH:somasaKyuH:somasaKiByAm:somasaKiByaH:somasaKyuH:somasaKyoH:somasaKInAm:somasaKyO:somasaKyoH:somasaKizu:somasaKe:somasaKAyO:somasaKAyaH
